0,0 0,0 0,0 0,0 0,0 0,0 0,0 0,0 0,0 0,0 0,0
0,0 4,1 4,1 4,1 4,1 4,1 4,1 1,1 2,1 3,1 0,0
0,0 4,2 4,2 4,2 4,2 4,2 4,2 1,2 2,2 3,2 0,0
0,0 0,2 0,2 0,4 0,3 0,13 0,4 0,3 0,3 0,1 0,0
0,0 0,2 0,1 0,1 0,1 0,1 0,1 0,1 0,1 0,1 0,0
0,0 0,2 0,1 0,1 0,1 0,1 0,1 0,1 0,1 0,1 0,0
0,0 0,2 0,1 0,1 0,1 0,1 0,1 0,1 0,1 0,1 0,0
0,0 0,2 0,1 0,1 0,1 0,1 0,1 0,1 0,1 0,1 0,0
0,0 0,2 0,1 0,1 0,1 0,1 0,1 0,1 0,1 0,1 0,0
0,0 0,0 0,0 0,0 0,0 0,0 0,0 0,0 0,0 0,0 0,0