1,0 1,0 1,0 1,0 1,0 1,0 1,0 1,0 1,0 1,0 1,0
1,0 1,9 2,9 0,10 1,0 0,5 5,1 1,0 1,0 1,0 1,0
1,0 1,10 2,10 0,11 0,8 0,6 5,2 1,0 1,0 1,0 1,0
1,0 1,11 2,11 1,0 0,9 0,7 2,0 3,0 1,0 1,0 1,0
1,0 1,0 1,0 1,0 1,0 1,5 2,5 3,5 4,5 1,0 1,0
1,0 1,3 2,3 3,3 1,0 1,6 2,6 3,6 4,6 1,0 1,0
1,0 1,4 2,4 3,4 1,0 1,7 2,7 3,7 4,7 1,0 1,0
1,0 1,0 1,0 1,0 1,0 1,8 2,8 3,8 4,8 1,0 1,0
1,0 1,0 1,0 1,0 1,0 1,0 1,0 1,0 1,0 1,0 1,0
1,0 1,0 1,0 1,0 1,0 1,0 1,0 1,0 1,0 1,0 1,0