0,0 0,0 0,0 0,0 0,0 0,0 0,0 0,0 0,0 0,0 0,0 0,0 0,0
0,0 4,1 4,1 6,1 4,1 4,1 6,1 6,1 7,1 0,0 0,0 0,0 0,0
0,0 4,2 4,2 6,2 4,2 4,2 6,2 6,2 4,3 5,3 6,3 4,1 0,0
0,0 0,2 0,2 0,2 0,2 0,2 0,3 0,3 4,4 5,4 6,4 4,2 0,0
0,0 0,2 0,3 0,3 0,3 0,3 0,1 0,1 0,12 0,3 0,3 0,3 0,0
0,0 0,2 0,1 0,1 0,1 0,1 0,1 0,1 0,1 0,1 0,1 0,1 0,0
0,0 0,2 0,1 0,1 0,1 0,1 0,1 0,1 0,1 0,1 0,1 0,1 0,0
0,0 0,2 0,1 0,1 0,1 0,1 0,1 0,1 0,1 0,1 0,1 0,1 0,0
0,0 0,2 0,1 0,1 0,1 0,1 0,1 0,1 0,1 0,1 0,1 0,1 0,0
0,0 0,2 0,1 0,1 0,1 0,1 0,1 0,1 0,1 0,1 0,1 0,1 0,0
0,0 0,0 0,0 0,0 0,0 0,0 0,0 0,0 0,0 0,0 0,0 0,0 0,0