1,0 1,0 1,0 1,0 1,0 1,0 1,0 1,0 1,0 1,0 1,0 1,0 1,0
1,0 1,0 1,0 1,0 1,0 1,0 1,0 1,0 1,0 1,0 1,0 1,0 1,0
1,0 1,12 2,12 3,12 4,12 5,12 1,0 1,0 1,0 1,0 1,0 1,0 1,0
1,0 1,13 2,13 3,13 4,13 5,13 1,0 1,0 1,0 1,0 1,0 1,0 1,0
1,0 1,0 1,0 1,0 1,0 0,5 1,0 1,0 1,0 1,0 1,0 1,0 1,0
1,0 1,0 1,0 7,4 8,4 0,6 1,0 1,0 1,0 1,0 1,0 1,0 1,0
1,0 1,0 5,5 6,5 7,5 8,5 9,5 10,5 1,0 1,0 1,0 1,0 1,0
1,0 1,0 5,6 6,6 7,6 8,6 9,6 10,6 1,0 1,0 1,0 1,0 1,0
1,0 1,0 5,7 6,7 7,7 8,7 9,7 10,7 1,0 1,0 1,0 1,0 1,0
1,0 1,0 5,8 6,8 7,8 8,8 9,8 10,8 1,0 1,0 1,0 1,0 1,0
1,0 1,0 1,0 1,0 1,0 1,0 1,0 1,0 1,0 1,0 1,0 1,0 1,0